BBBBBBBBBBBBBBBBBBBBBBBBBBB
B                         B
B                         B
B                         B
B       11112221111       B
B       11112221111       B
B2222   22222222222   2222B
B       11112221111       B
B       11112221111       B
B                         B
B                         B
B                         B
B                         B
B                         B
B                         B