BBBBBBBBBBBBBBBBBB
B                B
B                B
B                B
B  1111    1111  B
B  1111    1111  B
B  111111111111  B
B  1111    1111  B
B  1111    1111  B
B                B
B                B
B                B
B                B
B                B
B                B
B                B
