BBBBBBBBBBBBBBBBBBBBBBBBBBBBBBBBBBBBB
B                                   B
B                                   B
B                                   B
B                                   B
B              555555               B
B                                   B
B                                   B
B                                   B
B                                   B
B                                   B
B                                   B
B                                   B
B                                   B
B                                   B
B                                   B
B                                   B
B                                   B
B                                   B
B                                   B
B                                   B
B                                   B
B                                   B