BBBBBBBBBBBBBBBBBBBBBBBBBBBBBB
B                            B
B                            B
B                            B
B        222222222222        B
B4444444444444444444444444444B
B    33333333333333333333    B
B        222222222222        B
B1111111111111111111111111111B
B                            B
B                            B
B                            B
B                            B
B                            B
B                            B
B                            B
B                            B
B                            B
B                            B
B                            B