BBBBBBBBBBBBBBBBBBBBBBBBBBBBBBBBBB
B                                B
B     2222222222222222222222     B
B     2                    2     B
B     2                    2     B
B     2333333333333333333332     B
B     2                    2     B
B     2                    2     B
B     2                    2     B
B11111111111111111111111111111111B
B                                B
B                                B
B                                B
B                                B
B                                B
B                                B
B                                B
B                                B
B                                B
B                                B
B                                B
B                                B